00000000000000000000001101101011110000000000100100000000000000000000000011000000000000000000000100001000000000000000000000000000000000000000
00000000000000000000101000101001001000000001100010000000000000000000000101001000000000000000001001100000000000000000000000000000000000000000
11000000000000001001001000010001000001100101000000000000000000000000000011001000000000000000000000000000000000000000000000000000000000000000
11000000000000010011010100010100000001111000000000000000000000000000000000100010000000001000000000000000000000000000000000000000000000000000
11100000000000000010011001101001000000100000000000000000000000000000000001000110000000000000000000001000000000000000000000000111000000000000
11111000000000001000110011010101001111000000000000000000000000000000000110100000000110000000000000011100000000000011111000000100000000000000
11111100000000010111010100010100001011110000000000000000000000000000000000100000001100000000000000001000000000000100000100000000001000000000
11111110000000100100010010001000111101110000100000000000000000000000000011000000000010001000000000000000000000001000000010000000011000000000
11111111100000101000000000000000000100010010000000000000000000000000001100110000000000000000000000000000000000000111111100000000000000000000
11111111110011001100000000000000001011010010100000000000000000000001110000011100000000110000000000000000000000000001010000000000000000000000
11111111111010010110000000000001011100110100100000000000000000000010000111110010100000001000000000000000000000000000000000000000000000000000
11111111111100001011100000000001011111001000010000000000000000001100000100010001011000000000000000000000000000000000000000000000000000000000
11111111111111000100010000001010111011111110000000000000000000001001000000000000010001000000000000000000000000000000000000000000000000000000
11111111111111000000101001010111111011111110010000000000000000001000000000000000101000000000000000000000000000000000000000000000000000000000
11111111111111000000000001000011000101110110000000000000001000011000000000000000000100100000000000000000000000000000000000000000000000000000
11111111111111100000000000000001111111111010000000000000100100011000000000000000000100011010110000000000000000000000000000000000000000000000
11111111111111110000010000000110111111101101000000000000100100010110000000000000000011010100000000000000000000000000000000000000000000000000
11111111111111110001111000000011010111111100000000000000110010001000000000000000111011110110100000000000000000000000000000000000000000000000
11111111111111111111000100011010111111111000010000000000010100001100000000000000011100111100000000000000000000000000000000000000000000000000
11111111111111110000000010100010111101110000000000000000101101110000000000000011101111111000000000000000000000000000000000000000011000000000
11111111111111111000000000000000111111100000000000000001010001000000000000000111111011111100000000000000000000000000000000000000111100000000
11111111111111111100000000000000001111000000000000000011011101100000000000000011111111010100000000000000000000000000000000000001111110000000
11111111111111111110000000000000111101100000000000000000100100100000000000000111111010111110000000000000000000000000000000000000111110000000
11111111111111111110000000000000000100100000000000000000000000011000000000000100111101010110000000000000000000000000000000000000111100000000
11111111111111111111000000000000000100000000001000000000000010011010011011011010010111110000000000000000000000000000000000000000000000000000
11111111111111111110000000000000000011000000000000000000000100101001010101000001001000000000000000000000000000000000000000000000000000000000
11111111111111111100000000000000001000010000000000000000000000100100100000111100100010000000000000000000000000000000000000000000000000000000
11111111111111111100000000000000110001000000010000000000000010110011110001011110000010000000000000000000000000000000000000000000000000000000
11111111111111111000000000000000001001010000000000000000000010000110111010010110110110000000000000000000000000000000000000000000000000000000
11111111111111110000000000000000010100001000000000000000000011111001110101110110101101000000000000000000000000000000000000000000000000000000
11111111111111100000000000000000001101000000000000000000000110101110110101001011111100000000000010100000000000000000000000000000000000000000
11111111111111100000000000000000001010001000000000000000000111100111010101111010111000100000000101011111110000000000000000000000000000100000
11111111111111000000000000000000000100001000000000000000000001110110011011011011110000000000001100100011111000000000000000000000000001110000
11111111111110000000000000000000000101011000000000000000000000111101101111111111100000010000001010010011111000000000000000000000000011111000
11111111111100000000000000000000000001000000000000000000000000000111111000001011010000000000001000000011111000000000000000000000000111111100
11111111111000000000000000000000000001011000000000000000000000000000100010100000001000000000001111111111111000000000000000000000000011111000
11111111110000000000000000000000010110001000000000000000000000000000010010001001100100000000001111111111111000000000000000000000000001110000
11111111000000000000000000000000100101000000000000000001110000000000100000001010100000000000000000000000000000000000000000000000000000100000
11111110000000000000000000000000011101100000000000000000000000000000111000010000000000000000000000000000000000000000000000000000000000000000
11111100000000000000000000000000010001000000000000000000000000000010001000001100100000000000000000000000000000000000000000000000000000000000
