00000000000000000000000000000000000000010000100000000000000000000011000000000000000000000000100100000000001111010110110000000000000000000000
00000000000000000000000000000000000000000110010000000000000000010010100000000000000000000001000110000000010010010100010100000000000000000000
00000000000000000000000000000000000000000000000000000000000000010011000000000000000000000000000010100110000010001000010010010000000000000011
00000000000000000000000000000000000000000000000000010000000001000100000000000000000000000000000000011110000000101000101011001000000000000011
00000000000011100000100000000000000000011000000000000000000001100110000000000000000000100000000000000100000010010110011001000000001000000111
00000000001111100000000000000000000000111000000000000001100000000101100000000000000000000000000000000011110010101011001100000000000000011111
00000000011111000000000000000000000000010000000000000000110000000100000000000000000000000000000000001111010000101000101011101000000000111111
00000000011000000000000000000000000000000000000000010001000000000011000000000000000000000000000100001110111100010001001000100100000001111111
00000000000000000000000111111111111000000000000000000000000000001100110000000000000000000000000001001000111111110000000000010100000111111111
00000000000000000000000100000000001000000000000000001100000000111000001110000000000000000000000101001011010000001110000000110011001111111111
00000000000000000000000101001010001000000000000000010000000101000000000001000000000000000000000100101100111010000000000001101001011111111111
00000000000000000000000100000000001000000000000000000000010010000000000000110000000000000000001000010011111010000000000111010000111111111111
00000000000000000000000100010000101000000000000000000010001000000000000010010000000000000000000001111111011101010000001000100011111111111111
00000000000000000000000100000000001000000000000000000000010100000000000000010000000000000000001001111111011111101010010100000011111111111111
00000000000000000000000100100100001000000000000000000100100001111111100001011111111000000000000001101111111111000010000000000011111111111111
00000000000000000000000111011111111000000000001101011000100000000000001111111111111110000000000001011111111110000000000000000111111111111111
00000000000000000000000000000000000000000000000000101011000110111111100000111111111100000000000010110111111101100000001000001111111111111111
00000000000000000000000000000000000000000000000101101111011101111111110000001111111100000000000000111111101011000000011110001111111111111111
00001111111111011000000000000000000000000000000000111100111001011111111111110111111000000000001000011111111101011000100011111111111111111111
00001000000000101000000000000000000000000000000011111111111111111111001111101110110100000000000000001110111101000101000000001111111111111111
00001001001000101000000000000000000000000000000000111111111111111111100000111111111111111000000000000111111100011111111000011111111111111111
00001000000000001000000000000000000000000000000000101011111111111100000011111110111111000000000000000011110000010000001000111111111111111111
00001111110111111000000000000000000000000000000001111101011111100011000011111111100100000000000000000111111100010100101001111111111111111111
00001000000000001000000000000000000000000000000001101010111100100000000001111111110000000000000000000100100000010100101011111111111111111111
00001000000000001000000000000000000000000000000000001111101001011010000001011001000000000000010000000000100000011111111011111111111111111111
00001001001100101000000000000000000000000000000000000000010010000010001010010100100000000000000000000011000000000000000001111111111111111111
00001111111111111000000000000000000000000000000000000001000100111100000000100100000000000000000000001000010000000000000000111111111111111111
00000000000000000000000000000000000000000000000000000001000000000000000000001101000000000000001000000010001100000000000000111111111111111111
00000000000000000000000000000000000000000000000000000001101100110011110111000001000000000000000000001010010000000000000000011111111111111111
00000000000000000000000000000000000000000000000000000010000000011000011010000100000000000000000000010000101000000000000000001111111111111111
00000000000000000000000000000000000111101111000000000000100011110000000000000000000000000000000000000010110000000000000000000111111111111111
00000100000000000000000000000000001011111110100000000000000000101110000000000000000000000000000000010001010000000000000000000111111111111111
00001110000000000000000000000000010100000001010000000000011000011110000000000000000000000000000000010000100000000000000000000011111111111111
00011111000000000000000000000000010100000001010000001000000000001110000000001100000000000000000000011010100000000000000000000001111111111111
00111111100000000000000000000000010100000001010000000000001011010000000000000000000000000000000000000010000000000000000000000000111111111111
00011111000000000000000000000000010111111111010000000000010000000101000100000000000000000000000000011010000000000000000000000000011111111111
00001110000000000000000000000000001111111111100000000000100110010001001000000000000000000000000000010001101000000000000000000000001111111111
00000100000000000000000000000000000000000000000000000000000101010000000100000000001110000000000000000010100100000000000000000000000011111111
00000000000000000000000000000000000000000000000000000000000000001000011100000000000000000000000000000110111000000000000000000000000001111111
00000000000000000000000000000000000000000000000000000000000100110000010001000000000000000000000000000010001000000000000000000000000000111111
